111111111
10P000001
100000001
100000001
1C00000E1
111111111
