111111111
1P1X00X01
1CXCCCCC1
100000011
1E0001101
111111111
