111111111
1CP0000r1
1CCCCCCC1
100000001
1C00000E1
111111111
