111111111
1X00001C1
10P000111
100000001
111100X01
100000ES1
111111101
