111111111
1XC0C01C1
1XP100101
101000001
111100X01
1C0000EX1
111111111
