111111111
1E00001C1
10P000111
100000001
111100001
100000E00
111111100
