111111111
1X00001C1
10P000101
100000001
111100XC1
100000ES1
111111111
