111111111
1X00C01C1
10PC00101
100000001
111100XC1
1C0000ES1
111111111
