1111111111111111111111111111111111
10PXXXXX11100000000000000000000011
1000000000000000000000000000000011
1000000000000000000000000000000011
1000000000100000000000000000000011
1000000000000000000000000000000011
1000000000000000000000000000000011
1000000000011111111100000000000011
100000000001ECC0000000000000000011
1000000000011010000000000000000001
100000000X000000000000000000000011
1000000000000000000000C00000000011
1000000000000000000000000000000011
10000000000000000000S0000000000011
10000000000C0000000000000000000011
1000000000000000000000000000000011
1111111111111111111111111111111111
